border_size=1
usage=map

Qxu, Qxu, Qxu, Qxu, Qxu, Qxu, Qxu, Qxu, Qxu, Qxu, Qxu, Qxu, Qxu, Qxu, Qxu, Qxu, Qxu, Qxu, Qxu, Qxu, Qxu, Qxu, Qxu, Qxu, Qxu, Qxu, Qxu
Qxu, Qxu, Qxu, Qxu, Qxu, Qxu, Qxu, Qxu, Qxu, Qxu, Qxu, Qxu, Qxu, Qxu, Qxu, Qxu, Qxu, Qxu, Qxu, Qxu, Qxu, Qxu, Qxu, Qxu, Qxu, Qxu, Qxu
Qxu, Qxu, Qxu, Qxu, Qxu, Qxu, Qxu, Qxu, Qxu, Qxu, Qxu, Qxu, Qxu, Qxu, Qxu, Qxu, Qxu, Qxu, Qxu, Qxu, Qxu, Qxu, Qxu, Qxu, Qxu, Qxu, Qxu
Qxu, Qxu, Qxu, Qxu, Qxu, Qxu, Qxu, Qxu, Qxu, Qxu, Qxu, Qxu, Qxu, Qxu, Qxu, Qxu, Qxu, Qxu, Qxu, Qxu, Qxu, Qxu, Qxu, Qxu, Qxu, Qxu, Qxu
Qxu, Qxu, Qxu, Qxu, Qxu, Qxu, Qxu, Qxu, Qxu, Qxu, Qxu, Qxu, Qxu, Qxu, Qxu, Qxu, Qxu, Qxu, Qxu, Qxu, Qxu, Qxu, Qxu, Qxu, Qxu, Qxu, Qxu
Qxu, Qxu, Qxu, Qxu, Qxu, Qxu, Qxu, Qxu, Uh, Qxu, Qxu, Qxu, Qxu, Qxu, Qxu, Qxu, Qxu, Qxu, Qxu, Qxu, Qxu, Qxu, Qxu, Qxu, Qxu, Qxu, Qxu
Qxu, Qxu, Qxu, Qxu, Qxu, Qxu, Uh, Uh, Cmy, Cmy, Cmy, Uh, Uh, Qxu, Uu, Qxu, Qxu, Qxu, Qxu, Qxu, Qxu, Qxu, Qxu, Qxu, Qxu, Qxu, Qxu
Qxu, Qxu, Qxu, Qxu, Qxu, Qxu, Uh, Uu, Cmy, 4 Kmy, Cmy, Rrc, Rrc, Uu, Uu, Uu, Cmy, Qxu, Qxu, Qxu, Qxu, Qxu, Qxu, Qxu, Qxu, Qxu, Qxu
Qxu, Qxu, Qxu, Qxu, Qxu, Qxu, Uu, Uu, Rrc, Cmy, Rrc, Ymnv, Rrc, Uu, Uu, Uu, Uu, Qxu, Qxu, Qxu, Qxu, Qxu, Qxu, Qxu, Qxu, Qxu, Qxu
Qxu, Qxu, Qxu, Qxu, Qxu, Uh, Uu, Rr, Rrc, Rrc, Rr, Rrc, Uu, Uu, Uu, Uu, Uu, Qxu, Qxu, Qxu, Qxu, Qxu, Qxu, Qxu, Qxu, Qxu, Qxu
Qxu, Qxu, Qxu, Qxu, Qxu, Uh, Uu, Rr, Rr, Rrc, Uu, Uu, Uu, Uu, Uu, Uu, Uu, Uu, Qxu, Qxu, Qxu, Qxu, Qxu, Qxu, Qxu, Qxu, Xu
Qxu, Qxu, Qxu, Qxu, Qxu, Uh, Uu, Uu, Uu, Rr, Uu, Uu, Uu, Uu, Uu, Uu, Uh, Uu, Uu, Qxu, Qxu, Qxu, Uu, Qxu, Rb, Xu, Xu
Xu, Qxu, Uh, Qxu, Uh, Uh, Uu, Uu, Uu, Rr, Rr, Uu, Uu, Uu, Uu, Uu, Qxu, Uh, Uh, Uu, Uh, Uh, Uu, Rb, Uu, Xu, Xu
Xu, Xu, Uu, Uh, Qxu, Uu, Uu, Uu, Uu, Uu, Uu, Rr, Uu, Uu, Uu, Uu, Uu, Uh, Uh, Uh, Qxu, Uh, Uu, Uu^Vu, Uu, Xu, Xu
Xu, Xu, Uu, Qxu, Uu, Uu, Uu, Uu, Uu, Uu, Uu, Rr, Rr, Uu, Uu, Uu, Uu, Qxu, Uu, Uh, Uu, Uu, Rb, Rb, Uu, Xu, Xu
Xu, Xu, Uu, Rb, Rb, Uu^Vu, Uu, Uu, Uu, Uu, Uu, Rr, Rr, Uu, Uu, Uu, Uu, Uu, Rb, Uu, Rb, Rb, Xos, Uu, Xos, Xos, Xos
Xos, Xos, Uu, Uu, Uu, Rb, Rb, Uu, Uu, Uu, Rr, Rr, Rr, Rr, Rr, Uu, Rb, Rb, Uu, Rb, Xos, Xos, Xos, Xos, Xos, Xos, Xos
Xos, Xos, Xos, Uu, Uu, Uu, Uu, Rb, Uu, Rr, Uu, Rr, Rr, Uu, Uu, Rb, Xos, Xos, Xos, Xos, Xos, Xos, Xos, Xos, Xos, Xos, Xos
Xos, Xos, Xos, Xos, Xos, Xos, Xos, Uu, Xos, Uu, Uu, Rr, Cmy, Rr, Xos, Xos, Xos, Xos, Rr, Xos, Rr, Rr, Rr, Rr, Xos, Xos, Xos
Xos, Xos, Rr, Rr, Rr, Xos, Xos, Xos, Xos, Xos, Xos, Rrc, Rrc, Rrc, Rrc, Xos, Rr, Rr, Rr, Rr, Rr, Rr, Rr, Rr, Xos, Xos, Xos
Xos, Xos, Rr, Rr^Vud, Rr, Rr, Xos, Xos, Rr, Xos, Rrc, Rrc, Rrc, Rrc, Rrc, Rrc, Rr, Xos, Xos, Rr, Xos, Rr, Xos, Xos, Xos, Xos, Xos
Xos, Xos, Rr, Rr, Rr, Rr, Rr, Rr, Rr, Rr, Xos, Xos, Rrc, Rrc, Rrc, Rrc, Rrc, Rr, Xos, Xos, Xos, Xos, Xos, Xos, Xos, Xos, Xos
Xos, Xos, Rr, Rr, Rr, Rr, Rr, Rr, Rr, Xos, Xos, Rrc, Rrc, Rrc, Xos, Rrc, Xos, Xos, Xos, Xos, Xos, Xos, Xos, Xos, Xos, Xos, Xos
Xos, Xos, Rr, Rr, Rr, Rr, Xos, Xos, Xos, Xos, Brym, Xos, Brym, Xos, Brym, Brym, Brym, Brym, Brym, Xos, Xos, Xos, Xos, Xos, Xos, Xos, Xos
Xos, Xos, Rr, Rr, Xos, Xos, Brym, Xos, Brym, Brym, Brym, Brym, Brym, Brym, Brym, Brym, Brym, Brym^Vypr, Brym, Brym, Xos, Xos, Brym, Xos, Xos, Xos, Xos
Xos, Xos, Xos, Xos, Xos, Xos, Brym, Brym, Brym, Brym, Brym, Brym, Brym, Brym, Brym, Brym, Brym, Brym, Brym, Brym, Xos, Brym, Brym, Brym, Brym, Xos, Xos
Xos, Xos, Xos, Xos, Brym, Xos, Brym, Brym, Brym, Brym, Brym, Brym, Cmy, Cmy, Cmy, Brym, Brym, Brym, Xol, Xos, Brym, Brym, Brym, Brym, Brym, Xos, Xos
Xos, Xos, Xos, Brym, Brym, Brym, Brym, Xol, Xol, Brym, Brym, Brym, Cmy, 1 Kmy, Cmy, Brym, Brym, Brym, Brym, Xol, Brym, Brym, Brym, Brym, Brym, Xos, Xos
Xos, Xos, Xos, Brym, Brym, Brym, Brym, Xol, Brym, Brym, Brym, Brym, Brym, Cmy, Brym, Brym, Brym, Brym, Brym, Brym, Xos, Xos, Brym, Brym, Xos, Xos, Xos
Xos, Xos, Xos, Brym, Brym, Brym, Xos, Xos, Brym, Brym, Brym^Vypr, Brym, Brym, Brym, Brym, Brym, Brym, Brym, Brym, Xos, Xos, Brym, Brym, Brym, Xos, Xos, Xos
Xos, Xos, Xos, Brym, Xos, Xos, Brym, Brym, Brym, Brym, Brym, Brym, Brym, Brym, Brym, Brym, Xol, Brym, Brym, Xos, Xos, Brym, Xos, Xos, Rd, Xos, Xos
Xos, Xos, Xos, Xos, Brym, Brym, Brym, Brym, Brym, Brym, Xol, Brym, Brym, Brym, Brym, Brym, Brym, Xol, Brym, Brym, Brym, Xos, Xos, Rd, Rd, Rd, Xos
Xos, Xos, Xos, Xos, Brym, Brym, Brym^Vypr, Brym, Brym, Xol, Brym, Brym, Brym, Brym, Brym, Brym, Brym, Brym, Brym, Brym, Re^Gye, Xos, Xos, Rd, Rd, Rd, Xos
Xos, Xos, Xos, Xos, Brym, Brym, Brym, Brym, Brym, Brym, Brym, Brym, Brym, Brym, Brym, Brym, Brym, Brym, Re^Gye, Re^Gye, Ds, Rd, Rd, Rd, Xos, Xos, Xu
Xos, Xos, Xos, Xos, Brym, Brym, Brym, Brym, Brym, Brym, Brym, Brym, Xos, Brym, Xos, Xos, Xos, Re^Gye, Ds, Ds, Ds, Ds, Ds, Rd, Rd, Xos, Xu
Xos, Xos, Xos, Xos, Xos, Brym, Brym, Brym, Xos, Brym, Xos, Xos, Xos, Xos, Xos, Xos, Rd, Rd, Ds, Ds, Ds, Ds, Ds, Rd, Xos, Xos, Xu
Xos, Xos, Xos, Xos, Xos, Xos, Xos, Xos, Xos, Xos, Xos, Xos, Xos, Xos, Xos, Xos, Rd, Rd, Ds, Ds, Ds, Ds^Dr, Ds, Rd, Xos, Xu, Xu
Xos, Xos, Xos, Xos, Xos, Xos, Xos, Xos, Xos, Xos, Xos, Xos, Rd, Xos, Rd, Rd, Ds^Dr, Ds, Ds, Ds, Ds, Ds, Ds, Rd, Xos, Xu, Xu
Xos, Xos, Xos, Xos, Xos, Xos, Xos, Xos, Xos, Xos, Rd, Rd, Rd, Rd, Ds, Ds, Ds, Ds, Ds, Ds, Ds, Ds, Ds, Rd, Rd, Xos, Xu
Xos, Xos, Xos, Xos, Xos, Xos, Xos, Xos, Rd, Rd, Rd, Rd, Ds, Ds, Ds, Ds, Ds, Ds, Ds, Ds, Ds, Ds, Ds, Ds, Rd, Xos, Xu
Xos, Xos, Xos, Xos, Xos, Xos, Xos, Xos, Rd, Rd, Rd, Rd, Rd, Ds, Ds, Ds, Ds, Ds, Ds, Ds, Ds, Ds, Ds, Ds, Rd, Xos, Xu
Xu, Xos, Xos, Xos, Rr, Xos, Xos, Xos, Rrc, Rd, Rrc, Rd, Ds, Ds, Ds, Ds, Ds, Ds^Dr, Ds, Ds, Ds, Ds, Ds, Ds, Rd, Xos, Xu
Xu, Xu, Xos, Rr, Uu^Vud, Rr, Rrc, Rrc^Gyw, Rrc^Gyw, Rrc, Rrc, Rrc, Ds, Ds, Ds, Ds, Ds, Ds, Ds, Ds, Ds, Ds^Dr, Ds, Ds, Rd, Xos, Xu
Xu, Xu, Xos, Rr, Rrc, Rrc, Rrc, Rrc, Rr, Rrc^Gyw, Xos, Rrc, Rrc, Ds, Ds, Ds, Ds, Ds, Ds, Ds, Ds, Ds, Rd^Vud, Rd, Xos, Xos, Xu
Xu, Xu, Xos, Rr, Rrc, Rrc, Rr, Rr, Xos, Xos, Rd, Rd, Rd, Ds, Ds^Dr, Ds, Ds, Ds, Rd, Rd, Rd, Rd, Rd, Rd, Xos, Xu, Xu
Xu, Xu, Xos, Rr, Rrc, Rrc, Rr, Xos, Xu, Xos, Xos, Rd, Rd, Ds, Ds, Ds, Rd, Rd, Xos, Rd, Xos, Xos, Xos, Xos, Xu, Xu, Xu
Xu, Xu, Xos, Rr, Rrc, Rrc, Rr, Xos, Xos, Xu, Xos, Rd, Ds, Ds, Rd, Rd, Xos, Xos, Xos, Xos, Xu, Xu, Xu, Xu, Xu, Xu, Xu
Xu, Xu, Xos, Rr, Rrc, Rrc, Rr, Uu^Vud, Xos, Xu, Xos, Rd, Rd, Rd, Xos, Xos, Xu, Xu, Xu, Xu, Xu, Xu, Xu, Xu, Uu^Vud, Xu, Xu
Xu, Xu, Xos, Rr, Rrc, Rrc, Rr, Rr, Xos, Xu, Xos, Rd, Xos, Xos, Xu, Xos, Xu, Xu, Xu, Xu, Rr, Xu, Rr, Rr, Rr, Xu, Xu
Xu, Xu, Xos, Rr, Rrc, Rrc, Rr, Xos, Xu, Xu, Xu, Xos, Xu, Xu, Xu, Xu, Rr, Xu, Rr, Rr, Rr, Rr, Rr, Rr, Rr, Xu, Xu
Xu, Xu, Xos, Rr, Rrc, Rrc, Rr, Xos, Xos, Xu, Xu, Xu, Xu, Xu, Xu, Rr, Rr, Rr, Rrc, Rr, Rrc, Rr, Rr, Rr, Rr, Xu, Xu
Xu, Xu, Xos, Rr, Rrc, Rrc, Cmy, Rr, Xos, Xos, Xos, Xos, Xos, Xu, Xos, Xu, Rrc^Gyw, Rrc, Rr, Rrc, Rr, Rr, Rr, Rr, Rr, Xu, Xu
Xu, Xu, Xos, Rr, Rr, 6 Kmy, Cmy, Rrc, Rrc, Rr, Rr, Rr, Rr, Xos, Rrc, Rrc, Rrc, Xu, Xu, Rr, Xu, Rr, Rr, Rr, Rr, Xu, Xu
Xu, Xos, Xos, Rr, Xos, Rrc, Rrc, Cmy, Rrc, Rrc, Rrc, Rr, Rrc, Rrc, Rrc, Rrc, Xos, Xu, Xu, Xu, Xu, Xu, Rr, Rr, Rr, Xu, Xu
Xu, Xos, Xos, Xos, Rr, Rr, Rr, Rrc, Rrc, Rrc, Rrc, Rrc, Rrc, Rrc, Rrc, Rrc, Xos, Xu, Xu, Xu, Xu, Xu, Rr, Rr, Rr, Xu, Xu
Xu, Xu, Xos, Xos, Rr, Rr, Rr, Rr, Rr, Rrc, Rrc, Rrc, Rrc, Rrc, Rrc, Xos, Xu, Xu, Xu, Xu, Xu, Xu, Xu, Xu, Xu, Xu, Xu
Xu, Xu, Xos, Xos, Rr, Rr, Rr, Rr, Xos, Rrc, Rrc, Rrc, Rrc, Rrc, Rrc, Xos, Xu, Xu, Xu, Xu, Xu, Xu, Xu, Xu, Xu, Xu, Xu
Xu, Xu, Xu, Xos, Xos, Xos, Xos, Xos, Xu, Xos, Xos, Rrc, Rrc, Rrc, Rr, Xos, Xu, Xu, Uu, Xu, Xu, Xu, Xu, Xu, Xu, Xu, Xu
Xu, Xu, Xu, Xu, Xu, Xu, Xu, Xu, Xu, Xu, Xu, Rr, Rr, Rr, Ur, Uu, Xu, Xu, Ur, Uu, Uu, Uu^Vu, Uu, Xu, Uu, Xu, Xu
Xu, Xu, Xu, Xu, Xu, Xu, Xu, Xu, Xu, Xu, Xu, Uu, Ur, Ur, Ur, Ur, Ur, Ur^Gyw, Xu, Ur, Ur, Uu, Ur, Uu, Uu, Xu, Xu
Xu, Xu, Xu, Xu, Uu, Xu, Uu, Uu^Vu, Uu, Xu, Ur^Gyw, Ur, Xu, Uu, Uu, Ur, Uu, Xu, Xu, Xu, Uu, Ur, Ur, Ur, Uu, Xu, Xu
Xu, Xu, Xu, Xu, Uu, Uu, Ur, Ur, Ur, Ur, Uu, Xu, Xu, Xu, Uu, Ur, Uu, Uu, Xu, Xu, Uu, Ur, Ur, Ur, Uu, Xu, Xu
Xu, Xu, Xu, Xu, Uu, Ur, Ur, Ur, Ur, Ur, Uu, Xu, Xu, Xu, Xu, Ur, Ur, Uu, Xu, Xu, Uu, Uu, Ur, Ur, Uu, Uu, Xu
Xu, Xu, Xu, Xu, Uu, Uu, Uu, Ur, Uu, Ur, Uu, Uu, Xu, Xu, Uu, Uu, 3 Ur, Uu, Uu^Vu, Xu, Xu, Uu, Uu, Ur, Uu, Xu, Xu
Xu, Xu, Xu, Xu, Xu, Xu, Xu, Uu, Xu, Uu, Uu, Xu, Xu, Xu, Uu, Ur, Ur, Ur, Uu, Xu, Xu, Uu, Uu, Uu, Uu, Xu, Xu
Xu, Xu, Xu, Xu, Ms^Xm, Xu, Xu, Xu, Xu, Xu, Xu, Xu, Xu, Xu, Uu, Ur, Ur, Ur, Uu, Uu, Xu, Xu, Xu, Uu, Xu, Xu, Xu
Ms^Xm, Xu, Ms^Xm, Ms^Xm, Ms^Xm, Ms^Xm, Ms^Xm, Ms^Xm, Ms^Xm, Xu, Xu, Xu, Xu, Xu, Uu, Uu, Ur, Uu, Uu, Uu, Xu, Xu, Xu, Xu, Xu, Xu, Ms^Xm
Ms^Xm, Ms^Xm, Ms^Xm, Ms^Xm, Ms^Xm, Ms^Xm, Ms^Xm, Ms^Xm, Ms^Xm, Xu, Xu, Xu, Xu, Xu, Rr, Uu, Rr, Uu, Rr, Uu, Xu, Xu, Xu, Xu, Ms^Xm, Ms^Xm, Ms^Xm
Ms^Xm, Ms^Xm, Ms^Xm, Ms^Xm, Ms^Xm, Ms^Xm, Ms^Xm, Ms^Xm, Ms^Xm, Ms^Xm, Ms^Xm, Xu, Rr, Rr, Rr, Rr, Rr, Rr, Rr, Rr, Rr, Xu, Xu, Ms^Xm, Ms^Xm, Ms^Xm, Ms^Xm
Ms^Xm, Ms^Xm, Ms^Xm, Ms^Xm, Ms^Xm, Ms^Xm, Ms^Xm, Ms^Xm, Ms^Xm, Ms^Xm, Ms^Xm, Ms^Xm, Rr, Rr, 5 Cay, Rr, Rr, Rr, 2 Cay, Rr, Rr, Rr, Rr, Ms^Xm, Ms^Xm, Ms^Xm, Ms^Xm
Ms^Xm, Ms^Xm, Ms^Xm, Ms^Xm, Ms^Xm, Ms^Xm, Ms^Xm, Ms^Xm, Ms^Xm, Ms^Xm, Ms^Xm, Rr, Rr, Rr, Rr, Rr, Rr, Rr, Rr, Rr, Rr, Rr, Ms^Xm, Ms^Xm, Ms^Xm, Ms^Xm, Ms^Xm
Ms^Xm, Ms^Xm, Ms^Xm, Ms^Xm, Ms^Xm, Ms^Xm, Ms^Xm, Ms^Xm, Ms^Xm, Ms^Xm, Ms^Xm, Rr, Rr, Rr, Rr, Rr, Rr, Rr, Rr, Rr, Rr, Rr, Ms^Xm, Ms^Xm, Ms^Xm, Ms^Xm, Ms^Xm