border_size=1
usage=map

Xos, Xos, Xos, Xos, Xos, Xos, Xos, Xos, Xos, Xos, Xos, Xos, Xos, Xos
Xos, Xos, Xos, Xos, Xos, Xos, Xos, Xos, Xos, Xos, Xos, Xos, Xos, Xos
Xos, Xos, Xos, Xos, Xos, Xos, Xos, Xos, Xos, Xos, Xos, Xos, Xos, Xos
Xos, Xos, Xos, Xos, Xos, Xos, Ce, Xos, Xos, Xos, Xos, Xos, Xos, Xos
Xos, Xos, Xos, Xos, Ce, Ce, Ce, Ce, Ce, Xos, Xos, Xos, Xos, Xos
Xos, Xos, Xos, Xos, Iwr^Xo, Ce, Ce, Ce, Ce, Xos, Xos, Xos, Xos, Xos
Xos, Xos, Xos, Xos, Iwr, Iwr^Xo, Iwr^Xo, Iwr^Xo, Iwr^Xo, Iwr^Xo, Xos, Xos, Xos, Xos
Xos, Xos, Xos, Xos, Iwr, Iwr, Iwr, Iwr, Iwr, Iwr, Xos, Xos, Xos, Xos
Xos, Xos, Xos, Xos, Iwr, Iwr, Ce, Iwr, Iwr, Iwr, Xos, Xos, Xos, Xos
Xos, Xos, Xos, Xos, Iwr, Ce, 1 Ke, Ce, Iwr, Iwr, Xos, Xos, Xos, Xos
Xos, Xos, Xos, Xos, Re, Ce, Ce, Ce, Re, Iwr, Xos, Xos, Xos, Xos
Xos, Xos, Xos, Xos, Re, Re, Rb, Re, Rb, Xos, Xos, Xos, Xos, Xos
Xos, Xos, Xos, Xos, Rb, Rb, Rb, Rb, Aa, Xos, Xos, Xos, Xos, Xos
Xos, Xos, Xos, Xos, Xos, Aa, Aa, Aa, Aa, Xos, Xos, Xos, Xos, Xos
